15 15
@11113211111111
111113331113311
110013331111111
110113331111111
100111111111113
101111444441333
101111455541113
101111455541133
101111444441111
101111111110001
100000000000101
111111111101101
111111111101101
111111111103331
11111111110333C